#################################
#...#..........................##
#.#.#.########.#######.##########
#.#.#.#..............#.........##
#...#########.#.######.##########
#.#..................#.#........#
#.#.#.#######..#####.#...######.#
#.#.#.#.....#.##------#.#.#.###.#
#.###.#.#.###.##------#.#.#.#...#
#.#.#.#.#.......------#.#.#...###
#.#.#.#.#.#.####------#.#.#.#.#.#
#.#.#.#.#.#.#.#########.#.#.#...#
#...#...#.#.#...........#.#...###
#.#.#.###.#...########.#....#..##
#...#...#.#.......######.##..#.##
#.#.#.###.#.#####.........####.##
#.#...#...#.#.....#####.#.##...##
#.#.#...###.####......#.#....#.##
#################################