#################################
#...#..........................##
#.#.#.########.#######.##########
#.#.#.#..............#.........##
#...#########.#.######.##########
#.#..................#.#.#.....##
#.#.#.######.#.#####.#...######.#
#.#.#.#...#.#.##------#.#.#.###.#
#.###.#.#.###.##------#.#.#.#...#
#.#.#.#.#.......------#.#.#...###
#.#.#.#.#.#.####------#.#.#.#.#.#
#.#.#.#.#.#.#.#########.#.#.#...#
#...#...#.#.#...........#.#...###
#.#.#.###.#...########.#.#.#...##
#...#...#.#........#####.#...#..#
#.#.#.###.#.####..........###..##
#.#...#...#.#####.#####.#..#...##
#.#.#...###.####......#.#..#.#.##
#################################