# . . . # . . . . . . . . . . . . . . . . . . . . . . . . . . ##
# . # . # . ################# . ########### . ##################
# . # . # . # . . . . . . . . . . . . . . # . . . . . . . . . ##
# . . . ############################### . # . ##### . ##########
# . # . . . . . . . . . . . . . . . . . . # . # . # . . . . . ##
# . # . # . ######### . # . ################ . # . # . ##### . #
# . # . # . # . . . # . # . ## - - - - - - # . # . # . ##### . #
##### . # . # . ##### . ###### - - - - - - # . # . # . # . . . #
# . # . # . # . # . . . . . . -- - - - - - # . # . # . . . #####
# . # . # . # . # . # . ###### - - - - - - # . # . # . # . # . #
# . # . # . # . # . # . # . ################ . # . # . # . . . #
# . . . # . . . # . # . # . . . . . . . . . . # . # . . . ######
# . # . ##### . # . . . ################### . # . # . # . . . ##
# . . . # . . . # . # . . . . . . . . ##### . # . . . # . . ####
# . # . # . ##### . # . ####### . # . . . . . . . . ##### . . ##
# . # . # . # . . . # . ####### . ########### . # . . # . . . ##
# . # . # . . . ##### . ####### . . . . . . # . # . . # . # . ##
